who: it shows who is logged into the system.

who -u: lists the user who are logged in.

who -q: all login names and number of users logged on.

ls: lists all the files in current directory.

ls -l: lists all the files in the long format, like whether they are readable,writable or executable and the ownership of it.

ls -f: does not sort the files and no color is displayed.

ls -a: lists all the files in the directory including the hidden files.

ls -t: sorts by modification time.

ls -u: unsorted list

ls -R: lists all subdirectories also.

cal: used to open a calendar inside the terminal.

cal -h: removes higlight of todays date.

cal -m: displays the specified month.

cal -w: prints the number of weeks below each column.

cal -y: displays a calendar of specified year.

uname: displays the system information.

uname -a: print all information.

uname -s : prints the kernel name.

uname -v: prints the kernel version.

uname -p: prints proccessor type.

uname -o: prints the operating system.

time: shows the system resource usage.

time -o: write all information to a file.

time -f: format the output of the time.

time -v: prints the version number of the time program.

date: displays the current date and time.

date -r: displays the modification time of a file.

date -s: set the time descibed by String value.

bc : opens a calculator inside the terminal.

bc -i: runs bc in interactive mode.

bc -q: runs bc with normal gnu welcome.
